SalePrice - 房价
MSSubClass: The building class
MSZoning: 一般区划 RM RL ...
LotFrontage: 与房产相连的街道的线性英尺
LotArea: 地块面积（平方英尺）
Street: 道路通行类型
Alley: 巷道通道类型
LotShape: 财产的总体形状
LandContour: 物业的平整度
Utilities: 可用公用设施类型
LotConfig:地块配置
LandSlope:房产坡度
Neighborhood: 艾姆斯市区内的实际位置
Condition1:距离主干道或铁路的距离
Condition2:距离主干道或铁路的距离（如果有第二条主干道或铁路）
BldgType: 住宅类型
HouseStyle:住宅风格
OverallQual: 整体材料和装修质量
OverallCond: 整体状况评级
YearBuilt: 原始建造日期
YearRemodAdd:改造日期
RoofStyle: 屋顶类型
RoofMatl: 屋顶材料
Exterior1st: 房屋外墙覆盖
Exterior2nd: 房屋外墙覆盖（如果有多种材料）
MasVnrType: 砌体贴面类型
MasVnrArea: 砌体贴面面积（平方英尺）
ExterQual: 外部材料质量
ExterCond: 外部材料的当前状况
Foundation: 地基类型
BsmtQual:地下室高度
BsmtCond:地下室的一般状况
BsmtExposure: 步入式或花园层地下室墙壁
BsmtFinType1: 地下室完工面积的质量
BsmtFinSF1: 类型 1 完工面积（平方英尺）
BsmtFinType2: 第二完工面积（如果有）的质量
BsmtFinSF2: 类型 2 完工面积（平方英尺）
BsmtUnfSF: 地下室未完工面积（平方英尺）
TotalBsmtSF: 地下室总面积（平方英尺）
Heating: 供暖类型
HeatingQC: 供暖质量和状况
CentralAir: 中央空调空调
Electrical: 电气系统
1stFlrSF: 一楼平方英尺
2ndFlrSF:二楼平方英尺
LowQualFinSF: 低质量装修平方英尺（所有楼层）
GrLivArea: 地上（地面）居住面积平方英尺
BsmtFullBath: 地下室全浴室
BsmtHalfBath: 地下室半浴室
FullBath: 地上全浴室
HalfBath: 地上半浴室
Bedroom: 地下室以上卧室数量
Kitchen: 厨房数量
KitchenQual: 厨房质量
TotRmsAbvGrd: 地上房间总数（不包括浴室）
Functional: 家庭功能评级
Fireplaces: 壁炉数量
FireplaceQu: 壁炉质量
GarageType: 车库位置
GarageYrBlt:车库建造年份
GarageFinish: 车库内部装修
GarageCars: 车库汽车容量
GarageArea: 车库面积（平方英尺）
GarageQual: 车库质量
GarageCond: 车库状况
PavedDrive: 铺砌车道
WoodDeckSF: 木甲板面积（平方英尺）
OpenPorchSF: 开放式门廊面积（平方英尺）
EnclosedPorch: 封闭式门廊面积（平方英尺）
3SsnPorch: 三季门廊面积（平方英尺）
ScreenPorch:屏风门廊面积（平方英尺）
PoolArea: 泳池面积（平方英尺）
PoolQC: 泳池质量
Fence: 围栏质量
MiscFeature: 其他类别未涵盖的其他功能
MiscVal: $价值杂项
MoSold: 销售月份
YrSold: 销售年份
SaleType: 销售类型
SaleCondition: 销售条件






